XXXXXXXXXXXX
XS...X.....X
XX.X...XX..X
X......X...X
XX.X...XX.XX
XX....X....X
X...XX.....X
X..X...XX..X
XXX....X.X.X
X.XXXXX.X.XX
XX....XXX.EX
XXXXXXXXXXXX
