XS..........XX
XXXXXXXXXXX..X
XXXXXXXXXXXX.X
XXXXXXXXXXXX.X
XXXXXXXXXXXX.X
XXXXXXXXXXXX.X
XXXXXXXXXXXX.X
XXXXXXXXXXXX.X
X.....EXXXXX.X
X.XXXXXXXXXX.X
X............X
XXXXXXXXXXXXXX
